NO images/blue_wall.xpm
SO images/brick_wall.xpm
WE images/paper_wall.xpm
EA images/wooden_wall.xpm
DOOR images/door.xpm

F 220,100,0
C 225,30,3

111111111111111111
100000000000000001
100000000000000001
111111110111111111
       1D1
111111110111111111
100000000000000001
100000000000000N01
100000000000000001
111111111111111111