NO images/wall1.xpm
SO images/wall2.xpm
WE images/wall3.xpm

F 0,128,0
C 0,0,235

111111111111111111111111111111111111111111111111111111111111
10000000000000000000000000000000N000000000000000000000000001
111111111111111111111111111111111111111111111111111111111111