NO images/wall1.xpm
SO images/wall2.xpm
WE images/wall3.xpm
EA images/wall4.xpm

F 0,128,0,11
C 0,0,235

111111111111111111111111111111111111111111111111111111111111
100000000000E00000000000000000000000000000000000000000000001
111111111111111111111111111111111111111111111111111111111111