NO images/wall1.xpm
SO images/wall2.xpm
WE images/wall3.xpm
EA images/wall4.xpm

F 0,128,0
C 0,0,235

111111111111111111111111111111111111111111111111111111111111
100000E0000000000000000000000000000000000000000000000000W001
111111111111111111111111111111111111111111111111111111111111