EA images/wooden_wall.xpm
SO images/brick_wall.xpm
NO images/blue_wall.xpm
WE images/paper_wall.xpm

F 0,128,0
C 0,0,235

111111111111111111111111111111111111111111111111111111111111
1000000000000000000000S0000000000000000000000000000000000001
111111111111111111111111111111111111111111111111111111111111