NO images/blue_wall.xpm
SO images/brick_wall.xpm
WE images/paper_wall.xpm
EA images/wooden_wall.xpm

C 225,0,0
F 0,100,0

111111111111111111
100000000000000001
100000000000000001
111111111111111111

111111111111111111
100000000000000001
100000000000000E01
100000000000000001
111111111111111111